0,0,0,0,0,0,0,0,0,0,0,0,0,0,0;
0,0,0,0,0,0,0,0,0,0,0,0,0,0,0;
0,0,1,1,1,1,1,1,1,1,1,1,1,0,0;
0,0,1,1,1,1,1,1,1,1,1,1,1,0,0;
0,0,1,1,2,2,2,2,2,2,2,1,1,0,0;
0,0,1,1,2,2,2,2,2,2,2,1,1,0,0;
0,0,1,1,2,2,3,3,3,2,2,1,1,0,0;
0,0,1,1,2,2,3,0,3,2,2,1,1,0,0;
0,0,1,1,2,2,3,3,3,2,2,1,1,0,0;
0,0,1,1,2,2,2,2,2,2,2,1,1,0,0;
0,0,1,1,2,2,2,2,2,2,2,1,1,0,0;
0,0,1,1,1,1,1,1,1,1,1,1,1,0,0;
0,0,1,1,1,1,1,1,1,1,1,1,1,0,0;
0,0,0,0,0,0,0,0,0,0,0,0,0,0,0;
0,0,0,0,0,0,0,0,0,0,0,0,0,0,0.

0, 7, 7.

0, 0w60, 0, 10;
0, 14w60, 0, 10;
7, 0w60, 0, 10;
7, 14w60, 0, 10;
14, 0w60, 0, 10w60, 0, 10;
14, 7w60, 0, 10;
14, 14w60, 0, 10;
0, 7w60, 0, 10.

10.

500.

true.

1.