3,0,0,0,0,0,0,3,0,0,0,0,0,0,3;
0,0,0,0,0,0,0,0,0,0,0,0,0,0,0;
0,0,3,3,3,3,3,3,3,3,3,3,3,0,0;
0,0,3,1,1,1,1,3,1,1,1,1,3,0,0;
0,0,3,1,2,2,2,3,2,2,2,1,3,0,0;
0,0,3,1,2,2,2,3,2,2,2,1,3,0,0;
0,0,3,1,2,2,3,3,3,2,2,1,3,0,0;
3,0,3,3,3,3,3,3,3,3,3,3,3,0,3;
0,0,3,1,2,2,3,3,3,2,2,1,3,0,0;
0,0,3,1,2,2,2,3,2,2,2,1,3,0,0;
0,0,3,1,2,2,2,3,2,2,2,1,3,0,0;
0,0,3,1,1,1,1,3,1,1,1,1,3,0,0;
0,0,3,3,3,3,3,3,3,3,3,3,3,0,0;
0,0,0,0,0,0,0,0,0,0,0,0,0,0,0;
3,0,0,0,0,0,0,3,0,0,0,0,0,0,3.

0, 7, 7.

0, 0w60, 0, 30;
0, 14w60, 0, 30;
7, 0w60, 0, 30;
7, 14w60, 0, 30;
14, 0w60, 0, 30;
14, 7w60, 0, 30;
14, 14w60, 0, 30;
0, 7w60, 0, 30.

10.

500.

true.

1.