0,0,0,0,0,0,0,0,0,0,0,0,0,0,0;
0,0,0,0,0,0,0,0,0,0,0,0,0,0,0;
0,0,0,0,0,0,0,0,0,0,0,0,0,0,0;
4,4,0,0,0,0,0,0,0,0,0,0,0,0,0;
4,4,4,0,0,0,0,0,0,0,4,4,4,0,0;
0,0,4,4,0,0,0,0,0,4,4,0,4,4,0;
0,0,4,4,0,0,0,0,0,4,0,0,0,0,0;
0,0,4,4,0,0,0,4,4,4,0,0,0,0,0;
0,0,4,4,0,0,4,4,4,4,0,0,0,0,0;
0,0,4,4,4,0,4,4,4,4,0,0,0,0,0;
0,0,0,0,4,4,4,4,0,0,0,0,0,0,0;
0,0,0,0,0,0,0,0,0,0,0,0,0,0,0;
0,0,0,0,0,0,0,0,0,0,0,0,0,0,0;
0,0,0,0,0,0,0,0,0,0,0,0,0,0,0;
0,0,0,0,0,0,0,0,0,0,0,0,0,0,0.

0, 14, 5, 
3, 2, 10, 
3, 3, 10, 
3, 3, 11, 
3, 4, 11, 
3, 5, 11, 
3, 6, 11, 
3, 7, 11, 
3, 5, 8, 
3, 5, 9, 
3, 5, 7, 
3, 5, 6, 
3, 6, 6, 
3, 7, 6, 
3, 8, 6, 
3, 8, 5, 
2, 3, 1, 
2, 6, 0, 
2, 6, 3, 
2, 4, 3, 
2, 9, 1, 
2, 10, 2, 
2, 12, 1, 
2, 1, 10, 
2, 1, 11, 
2, 9, 11, 
2, 11, 8, 
2, 12, 9, 
4, 4, 8, 
4, 6, 7, 
4, 8, 4.

0, 0w60, 0, 10;
0, 2w60, 0, 10;
0, 5w60, 1, 10.

10.

200.

true.

1.